3, 3, 3, 3, 3, 3, 3, 3, 3, 3, 3, 3, 3, 3, 3
3, 4, 0, 0, 6, 0, 6, 0, 0, 0, 6, 0, 0, 0, 3
3, 0, 3, 0, 3, 0, 3, 0, 3, 0, 3, 3, 3, 0, 3
3, 0, 3, 6, 3, 0, 3, 0, 3, 0, 0, 0, 3, 0, 3
3, 6, 3, 0, 3, 0, 3, 0, 3, 0, 3, 0, 3, 0, 3
3, 0, 3, 0, 3, 0, 3, 3, 3, 0, 3, 0, 3, 0, 3
3, 0, 0, 0, 3, 6, 0, 0, 3, 0, 3, 6, 3, 0, 3
3, 0, 3, 3, 3, 0, 3, 0, 3, 0, 3, 0, 3, 0, 3
3, 0, 0, 0, 3, 0, 3, 0, 3, 0, 3, 0, 3, 0, 3
3, 0, 3, 0, 3, 0, 3, 0, 3, 0, 3, 0, 3, 0, 3
3, 6, 3, 6, 3, 0, 3, 6, 3, 0, 3, 3, 3, 0, 3
3, 0, 3, 0, 3, 0, 3, 0, 3, 0, 6, 0, 3, 0, 3
3, 0, 3, 3, 3, 3, 3, 6, 3, 3, 3, 0, 3, 3, 3
3, 0, 3, 5, 0, 0, 0, 0, 0, 0, 3, 0, 0, 0, 3
3, 3, 3, 3, 3, 3, 3, 3, 3, 3, 3, 3, 3, 3, 3
